愛知県名古屋市守山区	桔梗平
富山県砺波市	大窪
島根県邑智郡美郷町	久保
愛知県稲沢市	横地
宮城県栗原市	高清水下折木
京都府京都市北区	北野東紅梅町
兵庫県明石市	大明石町
茨城県つくば市	羽成
徳島県美馬郡つるぎ町	一宇
滋賀県長浜市	高田町
富山県砺波市	高道
大阪府交野市	寺南野
新潟県長岡市	関東町
埼玉県熊谷市	西別府
愛媛県松山市	来住町
静岡県下田市	武ガ浜
石川県白山市	日向町
福井県小浜市	新小松原
栃木県日光市	宝殿
新潟県三島郡出雲崎町	神条
